            111111111111111111
         111111111111111111111111111
       111111111100000000000000001111
       11111000000000000000000000TT11
       111100000000000000000000TTTT11
      11111000000000000000000SSTTT1111
    111110000000000000000SSSSSTTTT1111
    11111100000000000SSSSSSSSSTTTTT111
        11111111TTTTTTTSSSSSSTTTTTT111
              111TTTTTTTTTTTTTTTT1111
                 1111111111111111
      11111
 111111SS1111
 111SSSSSS11
   11SS11